UTFT_Buttons	KEYWORD1

addButton	KEYWORD2
drawButtons	KEYWORD2
drawButton	KEYWORD2
enableButton	KEYWORD2
disableButton	KEYWORD2
relabelButton	KEYWORD2
buttonEnabled	KEYWORD2
deleteButton	KEYWORD2
deleteAllButtons	KEYWORD2
checkButtons	KEYWORD2
setTextFont	KEYWORD2
setSymbolFont	KEYWORD2
setButtonColors	KEYWORD2

BUTTON_DISABLED	LITERAL1
BUTTON_SYMBOL	LITERAL1
BUTTON_SYMBOL_REP_3X	LITERAL1
BUTTON_BITMAP	LITERAL1
BUTTON_NO_BORDER	LITERAL1
BUTTON_UNUSED	LITERAL1
